██  ██████████████████████████████████████████████████████████████████
██      ██      ██          ██          ██  ██          ██  ██      ██
██  ██████  ██████████  ██████  ██████████  ██  ██████  ██  ██  ██  ██
██                  ██                              ██  ██      ██  ██
██  ██  ██████████  ██  ██████████  ██  ██████████████████████  ██████
██  ██          ██              ██  ██  ██              ██  ██      ██
██  ██  ██  ██  ██  ██  ██████  ██████████  ██  ██  ██  ██  ██  ██████
██  ██  ██  ██  ██  ██      ██              ██  ██  ██              ██
██  ██████████████  ██████  ██  ██████████████  ██  ██  ██████  ██████
██              ██  ██  ██  ██              ██  ██  ██      ██      ██
██  ██████████████  ██  ██████  ██  ██████████████████████████████  ██
██      ██                  ██  ██  ██                  ██      ██  ██
██  ██  ██  ██  ██  ██  ██  ██  ██████  ██████  ██████████  ██████████
██  ██  ██  ██  ██  ██  ██  ██              ██                      ██
██  ██████████  ██████████████  ██  ██  ██████████  ██████  ██  ██████
██  ██                      ██  ██  ██          ██      ██  ██  ██  ██
██████  ██  ██  ██████  ██  ██████  ██  ██  ██████  ██  ██  ██████  ██
██      ██  ██      ██  ██  ██      ██  ██      ██  ██  ██          ██
██  ██  ██████  ██████  ██████████  ██  ██████  ██████████  ██  ██  ██
██  ██  ██          ██          ██  ██  ██  ██          ██  ██  ██  ██
██████████████████  ██████████  ██████  ██  ██████████████████████  ██
██                      ██          ██                      ██      ██
██  ██████████  ██  ██████████████  ██████  ██  ██████████████  ██████
██      ██      ██              ██      ██  ██              ██      ██
██  ██████████  ██  ██████  ██████  ██  ██  ██  ██████████████████  ██
██      ██      ██      ██      ██  ██  ██  ██          ██          ██
██  ██  ██████████  ██████  ██  ██  ██  ██  ██  ██  ██  ██████████████
██  ██          ██      ██  ██  ██  ██  ██  ██  ██  ██              ██
██  ██████████████  ██  ██████  ██  ██████  ██████  ██████  ██  ██  ██
██  ██              ██      ██  ██  ██      ██          ██  ██  ██  ██
██  ██  ██████████  ██  ██████  ██████████  ██████████  ██  ██  ██████
██  ██  ██      ██  ██  ██              ██      ██  ██  ██  ██  ██  ██
██  ██████████  ██  ██  ██  ██████████████  ██████  ██████  ██████  ██
██  ██              ██  ██      ██                      ██          ██
██████████████████████████████████████████████████████████████████  ██
***
██//██████████████████████████████████████████████████████████████████
██//    ██      ██          ██          ██  ██          ██  ██      ██
██//██████  ██████████  ██████  ██████████  ██  ██████  ██  ██  ██  ██
██//////////////////██                              ██  ██      ██  ██
██  ██  ██████████//██  ██████████  ██  ██████████████████████  ██████
██  ██          ██//////////////██  ██  ██              ██  ██      ██
██  ██  ██  ██  ██  ██  ██████//██████████  ██  ██  ██  ██  ██  ██████
██  ██  ██  ██  ██  ██      ██//            ██  ██  ██              ██
██  ██████████████  ██████  ██//██████████████  ██  ██  ██████  ██████
██              ██  ██  ██  ██//            ██  ██  ██      ██      ██
██  ██████████████  ██  ██████//██  ██████████████████████████████  ██
██      ██                  ██//██  ██                  ██      ██  ██
██  ██  ██  ██  ██  ██  ██  ██//██████  ██████  ██████████  ██████████
██  ██  ██  ██  ██  ██  ██  ██//////////    ██                      ██
██  ██████████  ██████████████  ██  ██//██████████  ██████  ██  ██████
██  ██                      ██  ██  ██//        ██      ██  ██  ██  ██
██████  ██  ██  ██████  ██  ██████  ██//██  ██████  ██  ██  ██████  ██
██      ██  ██      ██  ██  ██      ██//██      ██  ██  ██          ██
██  ██  ██████  ██████  ██████████  ██//██████  ██████████  ██  ██  ██
██  ██  ██          ██          ██  ██//██  ██          ██  ██  ██  ██
██████████████████  ██████████  ██████//██  ██████████████████████  ██
██                      ██          ██//////////            ██      ██
██  ██████████  ██  ██████████████  ██████  ██//██████████████  ██████
██      ██      ██              ██      ██  ██//            ██      ██
██  ██████████  ██  ██████  ██████  ██  ██  ██//██████████████████  ██
██      ██      ██      ██      ██  ██  ██  ██//////////██          ██
██  ██  ██████████  ██████  ██  ██  ██  ██  ██  ██  ██//██████████████
██  ██          ██      ██  ██  ██  ██  ██  ██  ██  ██//////        ██
██  ██████████████  ██  ██████  ██  ██████  ██████  ██████//██  ██  ██
██  ██              ██      ██  ██  ██      ██          ██//██  ██  ██
██  ██  ██████████  ██  ██████  ██████████  ██████████  ██//██  ██████
██  ██  ██      ██  ██  ██              ██      ██  ██  ██//██  ██  ██
██  ██████████  ██  ██  ██  ██████████████  ██████  ██████//██████  ██
██  ██              ██  ██      ██                      ██//////////██
██████████████████████████████████████████████████████████████████//██
